4 5 4984 2739 76 6043 4297 
2 7 4297 6021 5997 5983 3533 3361 1863 
4 9 4297 4931 200 3432 4010 2945 4039 6058 1100 
4 6 4297 6092 3884 6143 6172 1781 
4 3 4620 1781 4774 
4 16 6980 5451 4431 296 6926 3186 5031 726 2843 4476 6898 437 3494 4930 2147 4006 
5 6 4006 6800 6760 6750 708 4628 
5 12 4628 2483 2180 3114 6720 2318 549 6708 573 4447 1437 6610 
4 3 5094 2365 3125 
3 5 3125 2375 2211 6276 6252 
4 4 6252 4061 6247 4710 
4 4 4710 2092 2694 6235 
4 9 6235 4685 4427 4704 5437 1757 6159 6130 557 
4 5 5853 5827 5792 5778 2768 
3 6 5853 5858 3732 1440 5872 3861 
3 7 1088 6022 2169 1888 6024 3292 4468 
1 2 4468 1100 
3 4 7233 3387 7241 7230 
3 6 7230 4991 7284 1338 7318 7323 
2 5 7230 7238 4347 1143 4994 
2 6 4994 3629 7250 676 4162 7245 
4 5 557 1404 6078 5226 6022 
2 5 1863 5893 3298 4572 2119 
3 5 5179 4879 1472 6038 2897 
4 7 5179 1312 84 5096 1641 3065 4984 
3 9 84 1943 3458 1661 2895 447 1590 1304 4620 
2 7 4984 6004 5989 1242 4211 1234 2119 
2 7 2897 1968 3469 2533 578 4295 6152 
3 5 2897 5257 5984 5310 1458 
2 9 1590 3657 2252 4341 3618 6292 311 5162 1831 
2 3 1831 1808 3026 
2 8 1312 3615 5242 3874 6226 5107 6300 311 
2 6 1458 759 4148 149 906 5783 
2 8 5179 2951 3098 5991 5962 5938 4667 5919 
1 4 5919 2360 5923 4211 
2 4 5938 5911 5895 4148 
3 6 2119 2756 5822 3013 2639 4330 
2 8 5783 2144 3937 5705 961 2417 502 5648 
2 10 502 3667 1370 4426 5634 2559 5616 636 5080 3300 
1 4 3300 2724 2041 4434 
2 5 4434 2447 2261 2294 306 
1 8 2261 2393 2592 3207 1294 3917 5625 3631 
3 6 306 5438 2121 4055 2020 3468 
3 6 4055 5660 4500 1350 3279 4824 
3 10 4330 5762 2470 5713 2953 3270 1918 2777 5400 306 
1 4 5762 934 514 4742 
2 9 3468 5712 767 1236 1719 5826 5857 1869 5886 
2 3 5886 1851 2466 
1 6 4742 3687 2774 4896 4612 1719 
4 6 4774 4449 3202 6324 719 6348 
1 6 573 5510 1807 2516 4869 925 
1 5 925 2544 356 6756 1124 
1 6 1124 3680 6711 2416 3708 6677 
1 4 6677 4237 6614 5485 
1 7 5485 3532 4231 2952 3649 6542 392 
1 5 3649 1064 3346 2342 3827 
1 4 392 4923 5530 1203 
1 6 5485 6564 4906 640 6527 4560 
1 7 640 4743 1905 4942 6433 4072 1831 
1 6 640 1290 2176 709 1741 2031 
1 3 2031 2868 6348 
5 4 4323 2311 2402 6851 
5 8 6851 5198 5301 5424 6860 6872 6899 3972 
3 8 5094 3538 6349 6326 2596 6280 1190 2769 
2 4 2769 4462 1425 2540 
2 5 2540 5524 3552 6113 1391 
2 9 1391 1892 6064 6044 6015 3816 3543 4584 1452 
3 10 1452 1085 3446 965 5780 5106 5768 3004 5069 2768 
2 5 3004 1725 4048 2575 5655 
1 8 2575 3467 4466 67 860 4748 704 4657 
2 6 4657 2826 2464 4047 3940 5658 
2 7 2464 5763 3392 5806 4959 2070 5040 
2 6 5040 4874 5517 1774 6062 4753 
3 7 4753 5287 1611 4977 2840 6240 1190 
2 6 4824 3043 5661 5673 2383 5658 
1 6 3125 2892 6400 1406 5439 6387 
3 9 5094 6419 3414 4621 4103 6528 943 495 5053 
3 5 5053 6602 3230 6634 5046 
3 8 5046 6694 4307 4227 3576 4311 1840 2147 
2 8 4476 6874 2373 6825 4208 2983 6771 3517 
2 18 3517 2066 6697 2888 848 6642 3923 591 1910 2370 6538 2436 6499 6481 6469 3335 2202 5094 
2 13 6481 3658 1819 6460 4314 1146 4266 6373 3949 650 5365 5549 3985 
1 11 4704 6251 3919 6305 2021 2738 6386 3091 6431 1209 1203 
1 5 5046 825 6639 6626 3923 
1 16 495 4796 3594 2700 3260 4591 58 869 4066 3203 292 4614 6653 6672 1604 6720 
3 11 1124 3005 3460 6844 4803 3428 6916 2250 2315 6960 6977 
1 6 6977 2539 7055 3219 1072 614 
3 6 4803 3252 3868 6869 6876 6885 
1 7 3868 6907 3637 1418 6968 3144 7018 
1 8 7018 7046 3992 4672 4717 1364 4988 5041 
3 8 6977 3017 1219 4285 7041 7061 3757 7081 
3 5 7081 5497 3622 4212 3290 
3 8 3622 2550 5434 7089 2529 7042 3837 6996 
3 5 6996 2615 3023 7059 5038 
2 5 6996 4086 594 6935 6913 
3 10 5038 7090 3991 3769 1293 7082 7093 3284 3226 7111 
3 6 7111 7138 3357 4678 7216 7245 
3 6 7111 7107 7094 4172 7071 620 
3 6 620 7067 681 2878 7003 6980 
2 7 620 4392 7139 826 4752 1516 7230 
1 4 7245 7248 2594 7305 
2 7 7245 7216 1049 7227 5309 1361 7286 
2 7 7286 1868 888 4969 1226 7226 7201 
2 5 7201 2935 2511 3536 5038 
4 6 5428 2967 6927 1797 1995 6851 
3 8 5428 6962 6972 3258 7015 1916 3396 3824 
2 13 3972 4594 6875 6863 3910 4229 4814 6880 6884 1931 3426 6862 4677 
3 7 3972 5189 4260 1251 6955 1973 7015 
2 11 3824 7051 4859 7020 4862 1228 2548 7009 1305 2091 5480 
2 7 4677 2083 97 740 3651 6992 5480 
2 4 4677 254 4828 6775 
2 8 6775 4823 4096 1877 6651 5163 2512 2709 
2 3 2709 663 1873 
3 6 2709 6568 2349 2578 6530 2175 
2 7 1873 5295 4822 371 1042 3553 6374 
3 6 6374 2956 3324 1575 6253 3810 
3 6 3324 6313 6289 675 5055 73 
1 4 73 2074 605 4669 
3 10 5090 2714 6188 4429 355 6150 861 1854 4038 179 
3 7 5090 6237 3348 4195 3416 6204 6215 
3 5 6215 2798 6151 1277 5535 
3 9 1277 1627 1928 6119 4535 1297 3639 4958 2580 
2 5 2580 6345 6334 237 5190 
3 10 2580 4180 485 3931 526 6473 1635 3668 3034 4627 
3 5 4627 4471 1599 3621 6530 
1 15 4627 1321 6572 631 1762 2099 2106 5432 363 6864 744 3227 2215 6896 4677 
2 5 5535 1904 5338 1445 2258 
2 6 2258 1108 1989 4246 3666 3853 
2 6 675 6261 628 4146 3291 1325 
2 7 179 2799 951 6100 4127 2103 1325 
2 6 2103 6065 3748 3475 3934 2367 
3 7 2768 4383 4711 5735 4996 1274 3254 
3 9 3861 2152 1963 5875 2908 2963 4215 655 5824 
3 6 3254 5307 5790 4281 5838 2908 
1 9 4753 3156 4976 5361 6163 2310 2600 6227 6252 
2 14 6916 6909 1215 4416 388 1275 3229 4663 6832 4665 5116 583 3954 6720 
1 7 925 4450 6625 6601 6576 6558 392 
1 7 6558 3646 4029 4919 2304 4313 5329 
1 5 5530 6456 3827 4372 2031 
3 4 4323 1365 5003 1926 
2 4 4359 2081 7402 7391 
2 9 7391 1678 5171 962 2012 3855 327 4169 7323 
2 8 4359 7417 2848 2415 7467 2313 2384 7522 
4 15 7323 3405 4069 1468 7381 3983 4142 4470 3993 7406 3477 7410 1922 4574 4126 
3 16 4142 2626 7441 163 5534 2323 4401 2010 1872 7536 3431 7553 4161 3713 4618 4423 
2 9 7522 7515 2753 5462 7538 2328 1169 7550 4161 
4 7 1872 3071 2699 1601 3587 7529 7525 
1 8 7525 2085 4001 7567 995 2037 7608 2647 
4 18 7525 7519 4505 7507 1112 7499 5111 2860 7487 3038 2413 2143 7452 1113 4174 5216 702 2172 
3 6 3587 7556 1235 5505 2800 489 
3 17 489 2649 5143 4915 660 4782 5213 7631 1935 7641 4985 245 7646 2253 7645 915 1248 
2 7 4423 7560 3580 5399 7575 1332 4849 
2 8 4849 7596 4463 7616 7623 7630 7640 1248 
2 11 7623 4800 2558 7633 4898 5229 3117 7652 7660 5391 491 
3 8 1248 3753 4997 5321 512 5157 5151 7678 
2 5 7678 7689 3951 4735 7695 
3 12 7600 7587 4644 7559 3555 7530 3463 7504 4583 3406 7461 2172 
3 11 1452 343 5913 3568 5952 673 4098 2786 5898 5877 3732 
3 8 5824 4075 4947 126 5729 3846 5740 3853 
3 10 6348 6321 6301 6257 1422 1866 2016 3410 2460 4704 
1 6 1422 2670 1565 3105 2201 2945 
2 7 6090 2970 6096 2557 1620 4337 4097 
2 6 4337 4699 1685 4421 1622 5052 
2 9 1622 5864 3130 91 5793 2129 5782 5760 1288 
2 16 4295 116 6216 6233 6260 3143 6318 6347 3162 4338 6407 3609 6449 1628 6480 6470 
2 5 6470 6446 6401 4596 3026 
1 4 6260 6246 3197 1071 
1 7 1288 5711 5696 5697 1749 867 5246 
1 5 5246 2335 5752 5765 2144 
1 3 5517 3282 5957 
2 6 2367 3462 5990 782 5518 3861 
2 11 4429 2007 6079 5166 4262 5927 2795 5908 1318 1359 5824 
2 12 1926 1979 6737 4519 2247 4558 4245 6595 1756 3830 3762 4669 
1 7 605 2002 6547 2285 2929 4354 1873 
1 6 1452 2509 4866 5876 2628 4506 
1 7 4506 3800 4593 5807 3430 2243 5763 
1 4 1391 5330 2986 1880 
1 6 1880 4099 6249 3217 4794 3985 
1 7 7461 990 3310 3263 2428 5370 2251 
1 7 3846 5159 4210 1544 1804 109 83 
2 13 3824 2752 3233 11 5265 7218 5024 566 7302 460 7344 7371 4126 
2 18 7302 2027 4111 2707 7322 3370 173 7310 4101 2810 5372 1500 7283 3901 3889 1707 3287 7173 
2 8 5480 1455 7063 7079 3511 7097 7130 4404 
1 8 7173 1908 4404 7119 3869 5344 7039 5440 
1 3 4726 7356 902 
1 2 1365 616 
1 5 6760 4652 4502 4867 5512 
1 7 5361 3313 6122 3886 6072 3518 2968 
1 3 5806 183 2727 
1 8 2727 684 4852 5508 4503 4349 2193 4824 
1 3 4824 2019 3631 
1 5 4246 1770 5880 1012 4262 
2 2 2540 6209 
1 8 6387 4812 1832 6439 4312 5137 6502 4591 
1 4 6407 2634 2729 3180 
1 6 3180 2380 3833 2471 4539 5107 
1 8 3013 938 5761 2288 2361 3665 4084 5705 
1 7 4097 1120 6074 3636 6071 1258 565 
1 4 5705 5685 3638 4597 
1 7 3622 7047 4438 6991 581 6939 2864 
1 10 4105 5237 6520 6496 6475 2122 412 3528 1982 6433 
1 6 1544 2737 4746 5643 644 1161 
5 6 5428 5362 6967 3773 1600 9062 
5 3 9062 1778 4700 
5 2 4700 6980 
2 3 6928 6943 4700 
3 21 5523 4617 7233 3575 7180 5453 7101 2025 430 7008 9062 6966 792 3515 358 4602 564 6802 6785 616 4323 
1 7 2335 5800 5817 5839 685 2950 3752 
1 3 5219 5671 5696 
1 3 4334 3736 867 
1 5 5697 5722 5751 352 5810 
1 7 6090 436 6047 4544 4651 5978 3752 
1 3 3752 3031 5984 
1 7 5810 4300 5860 1340 2893 5988 4544 
1 12 1685 5902 3497 1729 2857 3747 5810 2496 3479 5803 4588 2335 
1 4 3002 2642 3027 3180 
1 5 628 6176 87 6165 1227 
1 7 4098 5253 6026 6068 1648 6107 6132 
1 11 6132 6140 1213 6187 1798 6228 3845 6239 5304 6307 7 
1 5 6239 6219 5101 6175 1227 
1 6 1798 4771 6223 6218 6217 4099 
1 8 6967 4902 6920 6903 4221 1995 3508 5097 
1 7 6913 3565 4668 4659 2775 141 7011 
1 10 5041 713 4698 2989 3522 7156 4857 4316 7117 614 
1 9 614 7157 874 7148 4785 32 3514 3757 7081 
1 9 2175 4493 3988 3332 828 2732 6474 645 4627 
1 7 5190 4684 6395 4213 1920 3344 4627 
1 11 2251 5064 4056 4078 7357 2046 4965 2703 2531 5264 7338 
1 19 7338 2282 7292 2246 24 3450 165 4050 386 3881 1683 4768 785 2914 6492 6457 2651 4063 3931 
1 9 1321 4407 2048 4498 9 3821 6524 873 785 
1 7 5440 3759 3654 249 5442 3095 6864 
1 8 249 653 576 3389 6934 2426 6890 386 
1 23 3517 4238 1023 5196 2624 1948 6617 369 928 4851 1097 4327 595 6581 1036 3633 6635 2911 4424 6690 6714 2331 1365 
1 6 4245 3709 6661 4301 3189 1036 
1 12 4245 6646 688 3617 6611 1677 2669 6599 1479 6609 3480 5163 
1 5 5512 3126 5218 6616 5079 
1 8 925 2030 4922 2693 6778 4353 3309 1275 
1 9 5094 3538 1714 6392 4982 3860 5427 382 4266 
1 5 4266 6360 4251 6316 2769 
1 10 369 6598 647 5436 6589 6606 2220 6627 2846 3923 
1 4 7011 2998 7025 1293 
1 11 7111 7091 3473 4046 4681 3434 4303 2141 6988 2582 6980 
1 3 4948 7183 2511 
1 3 3570 162 7226 
1 8 4162 7294 7795 4381 4721 7733 5388 7428 
1 6 4721 5127 7791 717 4070 7391 
1 5 7428 7311 3797 3234 5171 
1 3 1338 2866 4363 
1 11 7391 3352 7408 7411 7419 7427 2054 7455 7471 7490 2010 
1 9 368 5149 5134 2439 3650 7656 7644 7632 660 
1 11 6374 6382 537 4610 6317 6281 4004 5279 4252 2270 3810 
1 5 1544 3707 2570 1838 4947 
1 6 1161 1693 4138 3965 2645 5307 
1 5 1886 3485 1603 2697 951 
1 3 1886 1705 5908 
1 4 179 5209 6210 3810 
